1111111
1E00C01
1001001
10C0001
1110001
10000P1
1111111
